------------------------------X-XXXXX---------------------------------------------------------------
----------------------------------------------------------------------------------------------------
----------------------------------------------------------------------------------------------------
----------------------------------------------------------------------------------------------------
----------------------------------------------------------------------------------------------------
----------------------------------------------------------------------------------------------------
-----------X----------------------------------------------------------------------------------------
--E-------------------------------------------------------------------------------------------------
------------------------------------------------X---E-----------------------------------------------
----------------------------------------------XXX--<>-----------------------------------------------
---------------------------------------------------[]-----------------------------------------------
----------------E----------------------------------[]--------------------------------------X--------
--------XXX----<>--------------------------XXXXXXXXXXX----------------------------------------------
---------XX----[]------------------------XXXXXXXXXXXXX----------------------------------------------
XXXXXXXXXXXXXXX[]-------XXXXXXXXXXXXXXXXXXXXXXXXXXXXXX--------------------------------XXXXXXXXXXXXXX
